===========================
=            =            =
= ==== ===== = ===== ==== =
= ==== ===== = ===== ==== =
=                         =
= ==== = ========= = ==== =
=      =     =     =      =
====== =     =     = ======
====== ===== = ===== ======
====== =           = ======
====== = ========= = ======
=        =========        =
======   =========   ======
====== = ========= = ======
====== =           = ======
====== = ========= = ======
=            =            =
= ==== ===== = ===== ==== =
=    =               =    =
==== = == ======== = == ===
=       =    =     =      =
= ========== = ========== =
=                         =
===========================
