============================
=............==............=
=.====.=====.==.====.=====.=
=.====.=====.==.====.=====.=
=.====.=====.==.====.=====.=
=..........................=
=.====.==.========.==.====.=
=.====.==.========.==.====.=
=......==..........==......=
============================