============================
=............==............=
=.====.=====.==.====.=====.=
=.====.=====.==.====.=====.=
=.====.=====.==.====.=====.=
=..........................=
=.====.==.========.==.====.=
=.====.==.========.==.====.=
=......==....==....==......=
============================